-               - cd -
...             - ../..
....            - ../../..
.....           - ../../../..
a               - Atom Beta.
calc            - Simple calculator.
codepoint       - Get a characterâ€™s Unicode code point.
dataurl         - Create a data URL from a file.
dnsrecords      - Get all the DNS records.
extract         - Extract archives - use: extract <file>.
fs              - Determine size of a file or total size of a directory.
gita            - `git add`
gitco           - `git commit`
gitd            - `git diff --ignore-space-change` with diff-so-fancy
gitds           - `git diff --ignore-space-change --staged` with diff-so-fancy
gitfetchpr      - Fetch a pull request to a local branch.
gitch           - `git checkout`
gitl            - `git log --oneline --decorate`
gitprune        - Delete all merged branches locally and remotely.
gitpush         - Push the current branch to origin and track it.
gitr            - cd to the root git directory.
gits            - `git status`
gitsh           - `git show --ignore-space-change` with diff-so-fancy
gz              - Compare original and gzipped file size.
httpcompression - Provides the content encoding the specified resources are served with.
ipexternal      - Get the internet IP address of the network.
iplocal         - List the IP addesses of the computer.
l               - List all files in long format.
la              - List all files in long format, including dot files.
lsd             - List only directories.
mkd             - Create a new directory and enter it.
nodesecurity    - Checks the current Node.js project's dependencies for known security issues.
npmls           - `npm ls` without all the dependency fluff.
o               - Opens the current directory, otherwise opens the given file, directory or URL.
rem             - Converts px to rem.
server          - Start an HTTP server from a directory, optionally specifying the port.
unidecode       - Decode \x{ABCD}-style Unicode escape sequences.
uniencode       - Escape UTF-8 characters into their 3-byte format.
urlencode       - URL-encode strings.
